Date, Time, Open, High, Low, Last, Volume, NumberOfTrades, BidVolume, AskVolume
2019/11/29, 01:00:00, 26847, 26847, 26498, 26555, 50, 49, 31, 19
2019/11/29, 02:00:00, 26549, 26593, 26480, 26508, 116, 90, 35, 81
2019/11/29, 03:00:00, 26500, 26500, 26400, 26441, 38, 20, 13, 25
2019/11/29, 05:00:00, 26438, 26438, 26392, 26420, 32, 19, 19, 13
2019/11/29, 06:00:00, 26414, 26471, 26401, 26443, 66, 22, 10, 56
2019/11/29, 07:00:00, 26400, 26435, 26380, 26415, 87, 49, 62, 25
2019/11/29, 08:00:00, 26414, 26450, 26395, 26395, 158, 100, 73, 85
2019/11/29, 09:00:00, 26446, 26468, 26446, 26468, 4, 4, 0, 4
2019/11/29, 10:00:00, 26463, 26464, 26461, 26463, 6, 6, 2, 4
2019/11/29, 11:00:00, 26476, 26476, 26476, 26476, 1, 1, 0, 1
2019/11/29, 12:00:00, 26488, 26488, 26488, 26488, 1, 1, 0, 1
2019/11/29, 13:00:00, 26460, 26460, 26458, 26458, 3, 3, 3, 0
2019/11/29, 14:00:00, 26450, 26470, 26400, 26470, 10, 10, 6, 4
2019/11/29, 15:00:00, 26472, 26486, 26452, 26463, 9, 9, 2, 7
2019/11/29, 16:00:00, 26450, 26450, 26450, 26450, 1, 1, 1, 0
2019/11/29, 17:00:00, 26457, 26457, 26451, 26451, 2, 2, 0, 2
2019/11/29, 18:00:00, 26445, 26445, 26445, 26445, 1, 1, 1, 0
2019/12/2, 01:00:00, 26555, 26628, 26480, 26585, 476, 123, 268, 208
2019/12/2, 02:00:00, 26602, 26602, 26527, 26535, 45, 42, 20, 25
2019/12/2, 03:00:00, 26561, 26570, 26547, 26552, 7, 7, 3, 4
2019/12/2, 05:00:00, 26540, 26540, 26515, 26524, 49, 36, 39, 10
2019/12/2, 06:00:00, 26527, 26550, 26506, 26546, 40, 31, 12, 28
2019/12/2, 07:00:00, 26542, 26542, 26519, 26524, 11, 10, 7, 4
2019/12/2, 08:00:00, 26530, 26540, 26510, 26540, 24, 17, 16, 8
2019/12/2, 10:00:00, 26532, 26538, 26529, 26538, 3, 3, 2, 1
2019/12/2, 11:00:00, 26532, 26532, 26460, 26460, 6, 6, 6, 0
2019/12/2, 13:00:00, 26454, 26454, 26454, 26454, 2, 1, 2, 0
2019/12/2, 14:00:00, 26459, 26459, 26459, 26459, 1, 1, 0, 1
2019/12/2, 15:00:00, 26418, 26431, 26417, 26417, 3, 3, 2, 1
2019/12/2, 16:00:00, 26425, 26425, 26396, 26400, 7, 6, 5, 2
2019/12/2, 17:00:00, 26390, 26407, 26368, 26407, 7, 7, 4, 3
2019/12/2, 18:00:00, 26415, 26415, 26399, 26414, 8, 8, 3, 5
2019/12/3, 01:00:00, 26396, 26450, 26138, 26300, 243, 112, 67, 176
2019/12/3, 02:00:00, 26306, 26475, 26270, 26407, 411, 249, 104, 307
2019/12/3, 03:00:00, 26411, 26519, 26398, 26503, 188, 111, 61, 127
2019/12/3, 05:00:00, 26492, 26493, 26445, 26452, 59, 33, 46, 13
2019/12/3, 06:00:00, 26450, 26467, 26435, 26466, 73, 25, 12, 61
2019/12/3, 07:00:00, 26482, 26498, 26449, 26456, 214, 35, 197, 17
2019/12/3, 08:00:00, 26475, 26480, 26441, 26441, 78, 55, 55, 23
2019/12/3, 09:00:00, 26462, 26464, 26428, 26429, 8, 8, 3, 5
2019/12/3, 10:00:00, 26402, 26402, 26317, 26320, 159, 85, 145, 14
2019/12/3, 11:00:00, 26338, 26352, 26331, 26344, 28, 15, 20, 8
2019/12/3, 12:00:00, 26331, 26334, 26280, 26280, 106, 61, 101, 5
2019/12/3, 13:00:00, 26276, 26281, 26166, 26177, 173, 43, 75, 98
2019/12/3, 14:00:00, 26142, 26142, 26020, 26074, 62, 59, 47, 15
2019/12/3, 15:00:00, 26086, 26138, 26060, 26076, 28, 25, 10, 18
2019/12/3, 16:00:00, 26076, 26125, 26076, 26100, 14, 14, 5, 9
2019/12/3, 17:00:00, 26110, 26140, 26110, 26140, 14, 9, 0, 14
2019/12/3, 18:00:00, 26145, 26145, 26130, 26130, 3, 2, 1, 2
2019/12/4, 01:00:00, 26073, 26251, 26016, 26085, 308, 211, 111, 197
2019/12/4, 02:00:00, 26100, 26237, 26100, 26165, 52, 41, 22, 30
2019/12/4, 03:00:00, 26141, 26183, 26125, 26169, 29, 25, 17, 12
2019/12/4, 05:00:00, 26156, 26208, 26152, 26208, 17, 17, 6, 11
2019/12/4, 06:00:00, 26169, 26202, 26169, 26180, 10, 10, 4, 6
2019/12/4, 07:00:00, 26171, 26171, 26115, 26115, 26, 24, 17, 9
2019/12/4, 08:00:00, 26121, 26140, 26101, 26120, 56, 41, 41, 15
2019/12/4, 09:00:00, 26188, 26335, 26155, 26291, 69, 51, 51, 18
2019/12/4, 10:00:00, 26294, 26294, 26257, 26262, 86, 45, 29, 57
2019/12/4, 11:00:00, 26267, 26286, 26267, 26286, 4, 4, 0, 4
2019/12/4, 12:00:00, 26296, 26300, 26272, 26272, 5, 5, 2, 3
2019/12/4, 13:00:00, 26298, 26300, 26272, 26298, 11, 10, 3, 8
2019/12/4, 14:00:00, 26293, 26346, 26290, 26333, 49, 42, 20, 29
2019/12/4, 15:00:00, 26313, 26320, 26304, 26308, 19, 17, 8, 11
2019/12/4, 16:00:00, 26333, 26333, 26315, 26315, 14, 6, 12, 2
2019/12/4, 17:00:00, 26310, 26332, 26310, 26332, 3, 3, 1, 2
2019/12/4, 18:00:00, 26329, 26332, 26329, 26332, 2, 2, 1, 1
2019/12/5, 01:00:00, 26330, 26383, 26240, 26332, 222, 155, 99, 123
2019/12/5, 02:00:00, 26328, 26380, 26240, 26240, 90, 78, 56, 34
2019/12/5, 03:00:00, 26229, 26253, 26188, 26197, 157, 101, 116, 41
2019/12/5, 05:00:00, 26232, 26241, 26212, 26226, 44, 34, 14, 30
2019/12/5, 06:00:00, 26231, 26268, 26231, 26268, 105, 78, 16, 89
2019/12/5, 07:00:00, 26270, 26320, 26270, 26305, 60, 55, 20, 40
2019/12/5, 08:00:00, 26300, 26330, 26280, 26299, 83, 38, 19, 64
2019/12/5, 09:00:00, 26270, 26300, 26270, 26300, 17, 13, 6, 11
2019/12/5, 10:00:00, 26300, 26337, 26290, 26328, 26, 13, 22, 4
2019/12/5, 11:00:00, 26324, 26329, 26320, 26323, 9, 8, 5, 4
2019/12/5, 12:00:00, 26306, 26306, 26306, 26306, 1, 1, 1, 0
2019/12/5, 13:00:00, 26292, 26296, 26292, 26295, 6, 4, 2, 4
2019/12/5, 14:00:00, 26301, 26320, 26301, 26314, 7, 7, 2, 5
2019/12/5, 15:00:00, 26273, 26285, 26258, 26285, 25, 19, 8, 17
2019/12/5, 16:00:00, 26290, 26323, 26285, 26311, 19, 15, 3, 16
2019/12/5, 17:00:00, 26294, 26294, 26294, 26294, 1, 1, 1, 0
2019/12/5, 18:00:00, 26325, 26325, 26325, 26325, 1, 1, 0, 1
2019/12/6, 01:00:00, 26400, 26517, 26388, 26509, 644, 215, 259, 385
2019/12/6, 02:00:00, 26501, 26594, 26434, 26452, 328, 192, 195, 133
2019/12/6, 03:00:00, 26452, 26500, 26450, 26489, 410, 98, 154, 256
2019/12/6, 05:00:00, 26470, 26480, 26448, 26450, 132, 70, 72, 60
2019/12/6, 06:00:00, 26467, 26550, 26467, 26547, 126, 94, 31, 95
2019/12/6, 07:00:00, 26548, 26611, 26548, 26558, 86, 74, 44, 42
2019/12/6, 08:00:00, 26555, 26575, 26547, 26565, 125, 72, 66, 59
2019/12/6, 09:00:00, 26568, 26575, 26560, 26575, 6, 4, 2, 4
2019/12/6, 10:00:00, 26570, 26570, 26565, 26565, 6, 6, 4, 2
2019/12/6, 11:00:00, 26573, 26576, 26573, 26576, 3, 2, 0, 3
2019/12/6, 12:00:00, 26585, 26585, 26563, 26572, 12, 5, 8, 4
2019/12/6, 13:00:00, 26568, 26630, 26568, 26630, 20, 16, 6, 14
2019/12/6, 14:00:00, 26640, 26660, 26625, 26640, 21, 18, 5, 16
2019/12/6, 15:00:00, 26634, 26650, 26631, 26639, 17, 10, 12, 5
2019/12/6, 16:00:00, 26627, 26630, 26620, 26620, 6, 6, 4, 2
2019/12/6, 17:00:00, 26626, 26631, 26626, 26631, 2, 2, 0, 2
2019/12/6, 18:00:00, 26649, 26649, 26649, 26649, 1, 1, 0, 1
2019/12/9, 01:00:00, 26518, 26648, 26500, 26520, 200, 150, 99, 101
2019/12/9, 02:00:00, 26543, 26720, 26510, 26677, 244, 157, 68, 176
2019/12/9, 03:00:00, 26653, 26661, 26560, 26572, 69, 43, 51, 18
2019/12/9, 05:00:00, 26582, 26596, 26550, 26560, 318, 44, 287, 31
2019/12/9, 06:00:00, 26555, 26608, 26546, 26608, 22, 17, 5, 17
2019/12/9, 07:00:00, 26614, 26614, 26587, 26593, 175, 29, 17, 158
2019/12/9, 08:00:00, 26585, 26585, 26555, 26580, 77, 49, 57, 20
2019/12/9, 09:00:00, 26548, 26550, 26548, 26550, 3, 3, 2, 1
2019/12/9, 10:00:00, 26570, 26574, 26568, 26568, 4, 4, 1, 3
2019/12/9, 11:00:00, 26570, 26570, 26550, 26550, 3, 3, 2, 1
2019/12/9, 12:00:00, 26552, 26560, 26552, 26554, 20, 15, 5, 15
2019/12/9, 13:00:00, 26559, 26566, 26553, 26559, 12, 12, 5, 7
2019/12/9, 14:00:00, 26560, 26593, 26554, 26593, 23, 19, 5, 18
2019/12/9, 15:00:00, 26577, 26577, 26567, 26567, 6, 4, 6, 0
2019/12/9, 16:00:00, 26561, 26561, 26561, 26561, 1, 1, 1, 0
2019/12/9, 18:00:00, 26510, 26510, 26510, 26510, 1, 1, 1, 0
2019/12/10, 01:00:00, 26488, 26549, 26367, 26513, 138, 90, 75, 63
2019/12/10, 02:00:00, 26502, 26633, 26502, 26557, 216, 135, 125, 91
2019/12/10, 03:00:00, 26582, 26595, 26555, 26560, 44, 29, 24, 20
2019/12/10, 05:00:00, 26562, 26590, 26562, 26581, 40, 19, 9, 31
2019/12/10, 06:00:00, 26575, 26582, 26536, 26537, 45, 18, 38, 7
2019/12/10, 07:00:00, 26545, 26558, 26545, 26552, 31, 15, 20, 11
2019/12/10, 08:00:00, 26559, 26559, 26480, 26480, 120, 79, 70, 50
2019/12/10, 09:00:00, 26460, 26460, 26328, 26388, 75, 38, 55, 20
2019/12/10, 10:00:00, 26394, 26433, 26391, 26422, 65, 41, 29, 36
2019/12/10, 11:00:00, 26414, 26414, 26380, 26380, 5, 4, 5, 0
2019/12/10, 12:00:00, 26415, 26418, 26396, 26401, 8, 6, 3, 5
2019/12/10, 13:00:00, 26401, 26552, 26401, 26529, 96, 65, 25, 71
2019/12/10, 14:00:00, 26538, 26538, 26484, 26517, 43, 38, 25, 18
2019/12/10, 15:00:00, 26510, 26544, 26509, 26544, 19, 17, 6, 13
2019/12/10, 16:00:00, 26552, 26552, 26509, 26522, 6, 5, 3, 3
2019/12/10, 17:00:00, 26526, 26526, 26526, 26526, 1, 1, 0, 1
2019/12/10, 18:00:00, 26553, 26554, 26553, 26554, 4, 2, 0, 4
2019/12/11, 01:00:00, 26475, 26543, 26425, 26501, 127, 113, 71, 56
2019/12/11, 02:00:00, 26494, 26584, 26480, 26584, 112, 97, 46, 66
2019/12/11, 03:00:00, 26550, 26603, 26548, 26590, 65, 46, 42, 23
2019/12/11, 05:00:00, 26587, 26705, 26578, 26699, 103, 67, 20, 83
2019/12/11, 06:00:00, 26710, 26744, 26685, 26722, 74, 45, 27, 47
2019/12/11, 07:00:00, 26735, 26748, 26694, 26700, 136, 89, 56, 80
2019/12/11, 08:00:00, 26702, 26726, 26700, 26720, 233, 82, 153, 80
2019/12/11, 09:00:00, 26685, 26689, 26660, 26689, 12, 9, 4, 8
2019/12/11, 10:00:00, 26700, 26700, 26694, 26695, 7, 6, 5, 2
2019/12/11, 11:00:00, 26702, 26715, 26702, 26715, 4, 4, 0, 4
2019/12/11, 12:00:00, 26716, 26716, 26716, 26716, 1, 1, 0, 1
2019/12/11, 13:00:00, 26710, 26714, 26706, 26714, 3, 3, 2, 1
2019/12/11, 14:00:00, 26708, 26730, 26698, 26730, 8, 6, 5, 3
2019/12/11, 15:00:00, 26730, 26730, 26715, 26722, 9, 8, 6, 3
2019/12/11, 16:00:00, 26707, 26720, 26685, 26685, 479, 282, 132, 347
2019/12/11, 17:00:00, 26685, 26700, 26685, 26700, 48, 25, 10, 38
2019/12/11, 18:00:00, 26713, 26714, 26713, 26714, 101, 5, 0, 101
2019/12/12, 01:00:00, 26835, 27110, 26835, 27105, 1150, 179, 605, 545
2019/12/12, 02:00:00, 27108, 27160, 27047, 27106, 451, 231, 189, 262
2019/12/12, 03:00:00, 27108, 27112, 27082, 27106, 221, 180, 115, 106
2019/12/12, 05:00:00, 27089, 27116, 27050, 27104, 653, 315, 263, 390
2019/12/12, 06:00:00, 27110, 27138, 27094, 27116, 309, 287, 199, 110
2019/12/12, 07:00:00, 27113, 27117, 27074, 27092, 384, 309, 198, 186
2019/12/12, 08:00:00, 27098, 27120, 27060, 27062, 99, 68, 48, 51
2019/12/12, 09:00:00, 27073, 27078, 27073, 27077, 6, 6, 3, 3
2019/12/12, 10:00:00, 27076, 27080, 27017, 27038, 17, 15, 11, 6
2019/12/12, 11:00:00, 27043, 27046, 27043, 27046, 10, 5, 3, 7
2019/12/12, 12:00:00, 27019, 27035, 27019, 27025, 9, 8, 4, 5
2019/12/12, 13:00:00, 27022, 27022, 26983, 27000, 46, 42, 32, 14
2019/12/12, 14:00:00, 26993, 27224, 26993, 27224, 81, 51, 20, 61
2019/12/12, 15:00:00, 27250, 27574, 27250, 27363, 155, 87, 45, 110
2019/12/12, 16:00:00, 27358, 27361, 27200, 27200, 43, 28, 32, 11
2019/12/12, 17:00:00, 27237, 27271, 27200, 27264, 15, 14, 7, 8
2019/12/13, 01:00:00, 27520, 27638, 27500, 27544, 887, 276, 334, 553
2019/12/13, 02:00:00, 27549, 27591, 27516, 27576, 220, 95, 136, 84
2019/12/13, 03:00:00, 27580, 27676, 27580, 27649, 172, 72, 29, 143
2019/12/13, 05:00:00, 27652, 27700, 27637, 27697, 208, 80, 70, 138
2019/12/13, 06:00:00, 27698, 27740, 27657, 27739, 217, 85, 94, 123
2019/12/13, 07:00:00, 27740, 27808, 27700, 27808, 301, 98, 100, 201
2019/12/13, 08:00:00, 27785, 27786, 27725, 27778, 131, 49, 77, 54
2019/12/13, 09:00:00, 27804, 27850, 27797, 27850, 15, 11, 6, 9
2019/12/13, 10:00:00, 27863, 27915, 27852, 27900, 40, 33, 17, 23
2019/12/13, 11:00:00, 27896, 27896, 27823, 27823, 44, 24, 31, 13
2019/12/13, 12:00:00, 27823, 27835, 27690, 27710, 36, 32, 28, 8
2019/12/13, 13:00:00, 27745, 27842, 27740, 27842, 23, 18, 13, 10
2019/12/13, 14:00:00, 27761, 27761, 27580, 27700, 96, 79, 71, 25
2019/12/13, 15:00:00, 27800, 27952, 27600, 27600, 132, 93, 74, 58
2019/12/13, 16:00:00, 27602, 27650, 27527, 27583, 69, 42, 47, 22
2019/12/13, 17:00:00, 27607, 27607, 27600, 27600, 6, 6, 3, 3
2019/12/16, 01:00:00, 27666, 27792, 27588, 27743, 322, 197, 110, 212
2019/12/16, 02:00:00, 27766, 27815, 27645, 27649, 111, 87, 60, 51
2019/12/16, 03:00:00, 27643, 27730, 27629, 27662, 102, 73, 46, 56
2019/12/16, 05:00:00, 27668, 27703, 27668, 27679, 72, 30, 37, 35
2019/12/16, 06:00:00, 27670, 27720, 27670, 27720, 226, 32, 21, 205
2019/12/16, 07:00:00, 27709, 27710, 27643, 27652, 78, 29, 68, 10
2019/12/16, 08:00:00, 27650, 27675, 27595, 27675, 70, 63, 41, 29
2019/12/16, 09:00:00, 27660, 27670, 27643, 27670, 13, 10, 4, 9
2019/12/16, 10:00:00, 27679, 27679, 27658, 27658, 5, 3, 3, 2
2019/12/16, 11:00:00, 27672, 27688, 27672, 27688, 4, 4, 0, 4
2019/12/16, 12:00:00, 27689, 27695, 27685, 27695, 7, 7, 1, 6
2019/12/16, 13:00:00, 27699, 27730, 27698, 27730, 23, 21, 7, 16
2019/12/16, 14:00:00, 27740, 27770, 27725, 27750, 46, 31, 22, 24
2019/12/16, 15:00:00, 27755, 27790, 27755, 27783, 38, 31, 11, 27
2019/12/16, 16:00:00, 27795, 27799, 27778, 27778, 9, 8, 2, 7
2019/12/16, 17:00:00, 27796, 27796, 27786, 27786, 2, 2, 1, 1
2019/12/16, 18:00:00, 27780, 27800, 27780, 27800, 9, 6, 1, 8
2019/12/17, 01:00:00, 27744, 27846, 27687, 27787, 290, 216, 161, 129
2019/12/17, 02:00:00, 27786, 27865, 27647, 27830, 363, 181, 154, 209
2019/12/17, 03:00:00, 27808, 27946, 27808, 27919, 245, 132, 124, 121
2019/12/17, 05:00:00, 27943, 28000, 27930, 27978, 124, 82, 40, 84
2019/12/17, 06:00:00, 27980, 27980, 27872, 27873, 138, 80, 87, 51
2019/12/17, 07:00:00, 27877, 27930, 27877, 27920, 442, 115, 159, 283
2019/12/17, 08:00:00, 27900, 27913, 27878, 27906, 233, 36, 214, 19
2019/12/17, 09:00:00, 27892, 27898, 27888, 27898, 6, 3, 5, 1
2019/12/17, 10:00:00, 27900, 27900, 27850, 27864, 26, 15, 16, 10
2019/12/17, 11:00:00, 27860, 27875, 27847, 27875, 29, 12, 15, 14
2019/12/17, 12:00:00, 27888, 27892, 27880, 27880, 20, 11, 18, 2
2019/12/17, 13:00:00, 27880, 27910, 27872, 27898, 8, 8, 3, 5
2019/12/17, 14:00:00, 27890, 27906, 27867, 27880, 29, 17, 12, 17
2019/12/17, 15:00:00, 27888, 27938, 27888, 27937, 16, 13, 6, 10
2019/12/17, 16:00:00, 27928, 27935, 27917, 27930, 9, 8, 6, 3
2019/12/17, 18:00:00, 27954, 27962, 27954, 27962, 3, 3, 0, 3
2019/12/18, 01:00:00, 27987, 28054, 27918, 28010, 325, 218, 119, 206
2019/12/18, 02:00:00, 28001, 28112, 27900, 27915, 644, 270, 327, 317
2019/12/18, 03:00:00, 27910, 27958, 27872, 27944, 314, 90, 60, 254
2019/12/18, 05:00:00, 27914, 27980, 27906, 27930, 173, 52, 88, 85
2019/12/18, 06:00:00, 27925, 27930, 27888, 27924, 183, 79, 58, 125
2019/12/18, 07:00:00, 27920, 27968, 27903, 27965, 202, 78, 86, 116
2019/12/18, 08:00:00, 27981, 28008, 27964, 28008, 252, 115, 151, 101
2019/12/18, 09:00:00, 28003, 28026, 28002, 28025, 107, 22, 83, 24
2019/12/18, 10:00:00, 28027, 28041, 28011, 28011, 6, 6, 3, 3
2019/12/18, 11:00:00, 28018, 28019, 28000, 28000, 29, 8, 4, 25
2019/12/18, 12:00:00, 28002, 28002, 28002, 28002, 1, 1, 0, 1
2019/12/18, 13:00:00, 27987, 28004, 27987, 27992, 6, 4, 5, 1
2019/12/18, 14:00:00, 27990, 28009, 27982, 27983, 13, 9, 6, 7
2019/12/18, 15:00:00, 27977, 27980, 27959, 27970, 38, 23, 22, 16
2019/12/18, 16:00:00, 27984, 27984, 27965, 27965, 11, 8, 5, 6
2019/12/18, 17:00:00, 27976, 27983, 27976, 27983, 2, 2, 0, 2
2019/12/18, 18:00:00, 27994, 28008, 27994, 28008, 2, 2, 0, 2
2019/12/19, 01:00:00, 28026, 28051, 27896, 27915, 351, 158, 99, 252
2019/12/19, 02:00:00, 27914, 27933, 27777, 27789, 296, 179, 135, 161
2019/12/19, 03:00:00, 27817, 27839, 27810, 27818, 115, 67, 70, 45
2019/12/19, 05:00:00, 27810, 27865, 27810, 27865, 276, 96, 72, 204
2019/12/19, 06:00:00, 27865, 27915, 27863, 27891, 562, 112, 256, 306
2019/12/19, 07:00:00, 27888, 27907, 27870, 27902, 247, 114, 87, 160
2019/12/19, 08:00:00, 27914, 27944, 27885, 27885, 133, 89, 83, 50
2019/12/19, 09:00:00, 27887, 27894, 27880, 27885, 212, 24, 14, 198
2019/12/19, 10:00:00, 27867, 27910, 27863, 27892, 114, 26, 14, 100
2019/12/19, 11:00:00, 27892, 27903, 27869, 27880, 134, 53, 95, 39
2019/12/19, 12:00:00, 27880, 27892, 27848, 27852, 119, 66, 62, 57
2019/12/19, 13:00:00, 27850, 27855, 27837, 27854, 13, 12, 8, 5
2019/12/19, 14:00:00, 27856, 27877, 27853, 27877, 51, 12, 4, 47
2019/12/19, 15:00:00, 27876, 27911, 27863, 27904, 72, 33, 42, 30
2019/12/19, 16:00:00, 27910, 27940, 27905, 27940, 19, 18, 6, 13
2019/12/19, 17:00:00, 27930, 27930, 27918, 27921, 6, 5, 5, 1
2019/12/19, 18:00:00, 27940, 27955, 27940, 27955, 18, 10, 6, 12
2019/12/20, 01:00:00, 27900, 28089, 27842, 28073, 1407, 551, 583, 824
2019/12/20, 02:00:00, 28079, 28091, 27950, 28060, 2204, 758, 1287, 917
2019/12/20, 03:00:00, 28062, 28075, 28013, 28024, 1132, 357, 589, 543
2019/12/20, 05:00:00, 28018, 28025, 27977, 28012, 1356, 132, 1029, 327
2019/12/20, 06:00:00, 28005, 28005, 27910, 27930, 1341, 190, 779, 562
2019/12/20, 07:00:00, 27908, 27951, 27908, 27935, 418, 201, 164, 254
2019/12/20, 08:00:00, 27937, 28029, 27937, 28029, 1459, 210, 1030, 429
2019/12/20, 09:00:00, 28037, 28037, 28006, 28007, 556, 36, 508, 48
2019/12/20, 10:00:00, 28020, 28074, 28020, 28055, 83, 31, 15, 68
2019/12/20, 11:00:00, 28058, 28059, 28031, 28038, 90, 41, 60, 30
2019/12/20, 12:00:00, 28036, 28041, 28029, 28041, 127, 13, 75, 52
2019/12/20, 13:00:00, 28050, 28052, 28031, 28032, 203, 51, 60, 143
2019/12/20, 14:00:00, 28036, 28063, 28035, 28040, 208, 72, 111, 97
2019/12/20, 15:00:00, 28043, 28060, 28015, 28058, 211, 80, 143, 68
2019/12/20, 16:00:00, 28062, 28064, 28027, 28030, 109, 55, 66, 43
2019/12/20, 17:00:00, 28027, 28039, 28024, 28034, 30, 16, 17, 13
2019/12/20, 18:00:00, 28034, 28035, 28025, 28035, 55, 16, 45, 10
2019/12/23, 01:00:00, 28090, 28163, 28000, 28034, 8685, 1754, 4772, 3913
2019/12/23, 02:00:00, 28036, 28077, 27960, 27960, 7840, 1260, 4691, 3149
2019/12/23, 03:00:00, 27962, 28008, 27934, 27999, 4584, 976, 2006, 2578
2019/12/23, 05:00:00, 28001, 28002, 27963, 27976, 4223, 1036, 1627, 2596
2019/12/23, 06:00:00, 27974, 27986, 27947, 27966, 3631, 1128, 1693, 1938
2019/12/23, 07:00:00, 27967, 27989, 27963, 27980, 5092, 1131, 1772, 3320
2019/12/23, 08:00:00, 27981, 27991, 27944, 27945, 2534, 790, 1340, 1194
2019/12/23, 09:00:00, 27955, 27980, 27950, 27978, 614, 177, 354, 260
2019/12/23, 10:00:00, 27977, 27994, 27970, 27989, 208, 97, 95, 113
2019/12/23, 11:00:00, 27986, 27996, 27979, 27987, 126, 78, 76, 50
2019/12/23, 12:00:00, 27990, 27999, 27978, 27995, 401, 149, 97, 304
2019/12/23, 13:00:00, 27995, 27999, 27980, 27981, 166, 78, 69, 97
2019/12/23, 14:00:00, 27984, 27990, 27969, 27980, 191, 131, 87, 104
2019/12/23, 15:00:00, 27982, 27982, 27963, 27976, 898, 225, 303, 595
2019/12/23, 16:00:00, 27974, 27974, 27934, 27945, 386, 240, 181, 205
2019/12/23, 17:00:00, 27948, 27958, 27948, 27950, 85, 43, 20, 65
2019/12/23, 18:00:00, 27953, 27976, 27948, 27974, 49, 43, 17, 32
2019/12/24, 01:00:00, 27990, 28015, 27890, 27934, 9955, 1904, 4771, 5184
2019/12/24, 02:00:00, 27934, 27971, 27899, 27946, 8132, 2297, 3362, 4770
2019/12/24, 03:00:00, 27943, 27980, 27936, 27950, 4525, 1518, 2302, 2223
2019/12/24, 04:00:00, 27948, 27979, 27934, 27957, 3797, 277, 1841, 1956
2019/12/27, 01:00:00, 28145, 28302, 28106, 28262, 21751, 10073, 8347, 13404
2019/12/27, 02:00:00, 28262, 28341, 28246, 28295, 14034, 7756, 6449, 7585
2019/12/27, 03:00:00, 28295, 28326, 28280, 28298, 9010, 4073, 3732, 5278
2019/12/27, 04:00:00, 28299, 28299, 28299, 28299, 8, 3, 0, 8
2019/12/27, 05:00:00, 28300, 28320, 28250, 28274, 6100, 3724, 2952, 3148
2019/12/27, 06:00:00, 28275, 28315, 28247, 28292, 6394, 3453, 2377, 4017
2019/12/27, 07:00:00, 28293, 28333, 28284, 28324, 7816, 3640, 3230, 4586
2019/12/27, 08:00:00, 28324, 28334, 28299, 28323, 6036, 2617, 2430, 3606
2019/12/27, 09:00:00, 28312, 28353, 28297, 28336, 1390, 829, 485, 905
2019/12/27, 10:00:00, 28335, 28361, 28325, 28359, 885, 517, 405, 480
2019/12/27, 11:00:00, 28359, 28371, 28350, 28352, 558, 433, 321, 237
2019/12/27, 12:00:00, 28355, 28364, 28345, 28357, 501, 302, 180, 321
2019/12/27, 13:00:00, 28357, 28360, 28341, 28344, 510, 411, 217, 293
2019/12/27, 14:00:00, 28343, 28355, 28301, 28303, 1605, 1199, 865, 740
2019/12/27, 15:00:00, 28303, 28347, 28300, 28341, 880, 816, 424, 456
2019/12/27, 16:00:00, 28343, 28360, 28343, 28348, 542, 481, 272, 270
2019/12/27, 17:00:00, 28346, 28349, 28325, 28337, 291, 226, 146, 145
2019/12/27, 18:00:00, 28339, 28341, 28320, 28322, 342, 298, 202, 140
2019/12/30, 01:00:00, 28348, 28415, 28269, 28400, 30891, 27302, 15071, 15820
2019/12/30, 02:00:00, 28399, 28473, 28371, 28460, 28563, 25748, 13772, 14791
2019/12/30, 03:00:00, 28459, 28536, 28446, 28505, 18308, 16429, 9224, 9084
2019/12/30, 04:00:00, 28505, 28505, 28505, 28505, 48, 19, 0, 48
2019/12/30, 05:00:00, 28501, 28503, 28430, 28464, 13095, 11972, 7083, 6012
2019/12/30, 06:00:00, 28464, 28476, 28436, 28455, 8908, 7933, 4613, 4295
2019/12/30, 07:00:00, 28455, 28491, 28391, 28408, 13285, 12067, 7069, 6216
2019/12/30, 08:00:00, 28409, 28429, 28394, 28426, 5231, 4501, 2825, 2406
2019/12/30, 09:00:00, 28408, 28410, 28373, 28397, 1360, 1188, 663, 697
2019/12/30, 10:00:00, 28397, 28411, 28391, 28396, 959, 854, 478, 481
2019/12/30, 11:00:00, 28395, 28398, 28379, 28389, 747, 656, 382, 365
2019/12/30, 12:00:00, 28390, 28432, 28387, 28421, 1111, 976, 542, 569
2019/12/30, 13:00:00, 28421, 28458, 28420, 28453, 1465, 1276, 624, 841
2019/12/30, 14:00:00, 28452, 28467, 28389, 28396, 3298, 2965, 1748, 1550
2019/12/30, 15:00:00, 28396, 28403, 28323, 28339, 4123, 3728, 2128, 1995
2019/12/30, 16:00:00, 28339, 28362, 28328, 28350, 1278, 1184, 610, 668
2019/12/30, 17:00:00, 28351, 28362, 28335, 28335, 738, 628, 396, 342
2019/12/30, 18:00:00, 28336, 28340, 28272, 28309, 855, 782, 498, 357
2019/12/31, 01:00:00, 28320, 28408, 28280, 28295, 27769, 25117, 13808, 13961
2019/12/31, 02:00:00, 28296, 28325, 28219, 28237, 24601, 22004, 12666, 11935
2019/12/31, 03:00:00, 28237, 28290, 28198, 28285, 16681, 14333, 8258, 8423
2019/12/31, 04:00:00, 28282, 28295, 28243, 28270, 3375, 2411, 1876, 1499
2020/1/2, 01:00:00, 28363, 28515, 28211, 28498, 43965, 38934, 20821, 23144
2020/1/2, 02:00:00, 28499, 28618, 28482, 28553, 31633, 28870, 15141, 16492
2020/1/2, 03:00:00, 28552, 28585, 28516, 28551, 12018, 10985, 6355, 5663
2020/1/2, 04:00:00, 28552, 28552, 28552, 28552, 34, 20, 0, 34
2020/1/2, 05:00:00, 28551, 28575, 28458, 28568, 17952, 15920, 9062, 8890
2020/1/2, 06:00:00, 28569, 28599, 28561, 28580, 9954, 9109, 4746, 5208
2020/1/2, 07:00:00, 28582, 28631, 28570, 28577, 10848, 9694, 5256, 5592
2020/1/2, 08:00:00, 28578, 28613, 28568, 28606, 8093, 6942, 4165, 3928
2020/1/2, 09:00:00, 28628, 28668, 28605, 28662, 2518, 2189, 1269, 1249
2020/1/2, 10:00:00, 28661, 28663, 28636, 28638, 1072, 968, 633, 439
2020/1/2, 11:00:00, 28639, 28655, 28627, 28640, 1114, 1038, 559, 555
2020/1/2, 12:00:00, 28640, 28651, 28635, 28647, 788, 695, 369, 419
2020/1/2, 13:00:00, 28647, 28688, 28641, 28678, 1387, 1256, 647, 740
2020/1/2, 14:00:00, 28681, 28787, 28655, 28785, 5042, 4580, 2275, 2767
2020/1/2, 15:00:00, 28786, 28788, 28718, 28779, 4063, 3634, 2134, 1929
2020/1/2, 16:00:00, 28776, 28781, 28715, 28754, 1996, 1739, 1111, 885
2020/1/2, 17:00:00, 28754, 28794, 28747, 28790, 1174, 1010, 602, 572
2020/1/2, 18:00:00, 28788, 28822, 28773, 28822, 1261, 1118, 587, 674
2020/1/3, 01:00:00, 28882, 28947, 28682, 28692, 47217, 41792, 24603, 22614
2020/1/3, 02:00:00, 28692, 28759, 28481, 28583, 47384, 42874, 24677, 22707
2020/1/3, 03:00:00, 28582, 28619, 28496, 28547, 19121, 17492, 9589, 9532
2020/1/3, 04:00:00, 28550, 28550, 28550, 28550, 82, 21, 0, 82
2020/1/3, 05:00:00, 28550, 28566, 28464, 28515, 16260, 15154, 8175, 8085
2020/1/3, 06:00:00, 28515, 28541, 28493, 28520, 8749, 8087, 4510, 4239
2020/1/3, 07:00:00, 28520, 28539, 28469, 28470, 10141, 8883, 5311, 4830
2020/1/3, 08:00:00, 28469, 28485, 28425, 28443, 8863, 7669, 4313, 4550
2020/1/3, 09:00:00, 28430, 28430, 28370, 28381, 2677, 2166, 1429, 1248
2020/1/3, 10:00:00, 28381, 28413, 28279, 28300, 2658, 2427, 1433, 1225
2020/1/3, 11:00:00, 28299, 28332, 28289, 28309, 2074, 1942, 988, 1086
2020/1/3, 12:00:00, 28310, 28393, 28309, 28379, 2618, 2337, 1176, 1442
2020/1/3, 13:00:00, 28379, 28472, 28378, 28437, 3678, 3314, 1672, 2006
2020/1/3, 14:00:00, 28435, 28535, 28372, 28505, 5044, 4487, 2511, 2533
2020/1/3, 15:00:00, 28506, 28506, 28436, 28454, 3356, 2957, 1667, 1689
2020/1/3, 16:00:00, 28454, 28494, 28430, 28467, 1707, 1507, 841, 866
2020/1/3, 17:00:00, 28465, 28490, 28465, 28477, 512, 465, 259, 253
2020/1/3, 18:00:00, 28476, 28478, 28376, 28415, 1255, 1083, 681, 574
2020/1/6, 01:00:00, 28292, 28435, 28232, 28246, 41348, 36897, 20189, 21159
2020/1/6, 02:00:00, 28244, 28377, 28236, 28296, 31112, 28420, 15026, 16086
2020/1/6, 03:00:00, 28295, 28357, 28286, 28315, 12951, 11927, 6370, 6581
2020/1/6, 04:00:00, 28333, 28333, 28333, 28333, 78, 42, 0, 78
2020/1/6, 05:00:00, 28322, 28369, 28285, 28287, 12581, 11391, 6344, 6237
2020/1/6, 06:00:00, 28287, 28292, 28077, 28183, 27770, 24502, 14227, 13543
2020/1/6, 07:00:00, 28184, 28293, 28167, 28238, 15509, 13734, 7605, 7904
2020/1/6, 08:00:00, 28238, 28283, 28181, 28181, 7994, 6884, 3960, 4034
2020/1/6, 09:00:00, 28175, 28228, 28100, 28189, 3381, 3000, 1656, 1725
2020/1/6, 10:00:00, 28190, 28230, 28180, 28219, 1685, 1566, 768, 917
2020/1/6, 11:00:00, 28221, 28238, 28208, 28224, 1119, 990, 506, 613
2020/1/6, 12:00:00, 28227, 28265, 28224, 28238, 1501, 1376, 722, 779
2020/1/6, 13:00:00, 28238, 28239, 28176, 28213, 2432, 2206, 1182, 1250
2020/1/6, 14:00:00, 28212, 28266, 28169, 28242, 4130, 3796, 2039, 2091
2020/1/6, 15:00:00, 28241, 28307, 28241, 28280, 3329, 3014, 1594, 1735
2020/1/6, 16:00:00, 28281, 28291, 28250, 28258, 1811, 1548, 891, 920
2020/1/6, 17:00:00, 28255, 28278, 28249, 28277, 546, 478, 248, 298
2020/1/6, 18:00:00, 28275, 28314, 28274, 28312, 601, 545, 278, 323
2020/1/7, 01:00:00, 28418, 28515, 28306, 28475, 37981, 34424, 18607, 19374
2020/1/7, 02:00:00, 28474, 28529, 28369, 28421, 30595, 28111, 15111, 15484
2020/1/7, 03:00:00, 28421, 28454, 28391, 28434, 12427, 11591, 6114, 6313
2020/1/7, 04:00:00, 28439, 28450, 28439, 28450, 91, 37, 0, 91
2020/1/7, 05:00:00, 28450, 28452, 28386, 28415, 10393, 9624, 5187, 5206
2020/1/7, 06:00:00, 28416, 28439, 28360, 28431, 12990, 12013, 6234, 6756
2020/1/7, 07:00:00, 28430, 28446, 28291, 28303, 14459, 13038, 7655, 6804
2020/1/7, 08:00:00, 28304, 28382, 28282, 28382, 8643, 7546, 4240, 4403
2020/1/7, 09:00:00, 28359, 28391, 28354, 28377, 1502, 1355, 743, 759
2020/1/7, 10:00:00, 28378, 28395, 28345, 28367, 1324, 1161, 659, 665
2020/1/7, 11:00:00, 28366, 28378, 28333, 28347, 1071, 958, 541, 530
2020/1/7, 12:00:00, 28345, 28359, 28341, 28349, 704, 653, 320, 384
2020/1/7, 13:00:00, 28348, 28353, 28287, 28293, 1876, 1705, 982, 894
2020/1/7, 14:00:00, 28292, 28313, 28240, 28271, 4253, 3836, 2152, 2101
2020/1/7, 15:00:00, 28270, 28336, 28261, 28326, 3769, 3453, 1802, 1967
2020/1/7, 16:00:00, 28327, 28350, 28270, 28284, 2121, 1900, 1095, 1026
2020/1/7, 17:00:00, 28284, 28302, 28275, 28283, 666, 611, 329, 337
2020/1/7, 18:00:00, 28286, 28316, 28286, 28314, 548, 502, 244, 304
2020/1/8, 01:00:00, 27900, 28084, 27865, 27997, 50712, 44243, 23962, 26750
2020/1/8, 02:00:00, 27998, 28179, 27974, 28149, 39485, 35414, 19100, 20385
2020/1/8, 03:00:00, 28149, 28253, 28066, 28156, 28826, 25630, 14014, 14812
2020/1/8, 04:00:00, 28156, 28156, 28155, 28155, 116, 43, 9, 107
2020/1/8, 05:00:00, 28155, 28155, 27998, 28019, 16718, 14980, 8966, 7752
2020/1/8, 06:00:00, 28021, 28061, 28009, 28042, 10803, 9672, 5447, 5356
2020/1/8, 07:00:00, 28041, 28150, 28032, 28088, 13379, 11862, 6656, 6723
2020/1/8, 08:00:00, 28090, 28128, 28049, 28058, 8451, 6889, 4389, 4062
2020/1/8, 09:00:00, 28064, 28123, 28064, 28110, 1647, 1480, 796, 851
2020/1/8, 10:00:00, 28109, 28167, 28103, 28149, 1872, 1715, 863, 1009
2020/1/8, 11:00:00, 28150, 28177, 28133, 28144, 1836, 1717, 926, 910
2020/1/8, 12:00:00, 28144, 28169, 28131, 28154, 1494, 1392, 752, 742
2020/1/8, 13:00:00, 28152, 28222, 28142, 28188, 3197, 2936, 1610, 1587
2020/1/8, 14:00:00, 28187, 28236, 28136, 28231, 3378, 3103, 1630, 1748
2020/1/8, 15:00:00, 28233, 28252, 28193, 28219, 2746, 2463, 1314, 1432
2020/1/8, 16:00:00, 28220, 28449, 28192, 28387, 5503, 4559, 2547, 2956
2020/1/8, 17:00:00, 28386, 28452, 28386, 28431, 2198, 1681, 968, 1230
2020/1/8, 18:00:00, 28429, 28451, 28408, 28430, 744, 662, 348, 396
2020/1/9, 01:00:00, 28410, 28505, 28367, 28495, 35495, 32012, 17519, 17976
2020/1/9, 02:00:00, 28492, 28498, 28416, 28436, 25700, 23200, 13473, 12227
2020/1/9, 03:00:00, 28435, 28475, 28410, 28452, 11898, 10828, 6089, 5809
2020/1/9, 04:00:00, 28450, 28460, 28450, 28460, 33, 28, 1, 32
2020/1/9, 05:00:00, 28458, 28528, 28454, 28501, 14624, 12675, 7140, 7484
2020/1/9, 06:00:00, 28502, 28548, 28489, 28502, 11648, 10182, 5803, 5845
2020/1/9, 07:00:00, 28503, 28633, 28498, 28621, 15228, 13304, 7033, 8195
2020/1/9, 08:00:00, 28621, 28628, 28576, 28622, 8950, 6988, 4786, 4164
2020/1/9, 09:00:00, 28628, 28628, 28546, 28566, 2582, 2255, 1431, 1151
2020/1/9, 10:00:00, 28568, 28595, 28533, 28543, 2463, 2226, 1341, 1122
2020/1/9, 11:00:00, 28546, 28581, 28544, 28574, 1359, 1238, 618, 741
2020/1/9, 12:00:00, 28574, 28576, 28517, 28532, 2684, 2430, 1447, 1237
2020/1/9, 13:00:00, 28531, 28564, 28523, 28559, 1373, 1239, 673, 700
2020/1/9, 14:00:00, 28558, 28576, 28522, 28544, 3060, 2749, 1617, 1443
2020/1/9, 15:00:00, 28546, 28564, 28511, 28558, 2844, 2453, 1545, 1299
2020/1/9, 16:00:00, 28556, 28610, 28542, 28580, 2510, 2141, 1222, 1288
2020/1/9, 17:00:00, 28580, 28590, 28542, 28561, 1035, 864, 481, 554
2020/1/9, 18:00:00, 28561, 28589, 28532, 28584, 882, 841, 419, 463
2020/1/10, 01:00:00, 28666, 28726, 28553, 28602, 33636, 30159, 16938, 16698
2020/1/10, 02:00:00, 28602, 28624, 28539, 28621, 24444, 22517, 12319, 12125
2020/1/10, 03:00:00, 28620, 28686, 28607, 28637, 17621, 16084, 8655, 8966
2020/1/10, 04:00:00, 28638, 28638, 28638, 28638, 24, 19, 0, 24
2020/1/10, 05:00:00, 28638, 28670, 28591, 28665, 13342, 12153, 6631, 6711
2020/1/10, 06:00:00, 28665, 28707, 28651, 28677, 12383, 11486, 5779, 6604
2020/1/10, 07:00:00, 28676, 28690, 28651, 28675, 7876, 7052, 3991, 3885
2020/1/10, 08:00:00, 28676, 28690, 28640, 28666, 5636, 4773, 2882, 2754
2020/1/10, 09:00:00, 28655, 28696, 28649, 28692, 1204, 1061, 504, 700
2020/1/10, 10:00:00, 28693, 28719, 28689, 28709, 1385, 1200, 657, 728
2020/1/10, 11:00:00, 28710, 28736, 28708, 28714, 1347, 1192, 642, 705
2020/1/10, 12:00:00, 28716, 28719, 28704, 28710, 576, 522, 288, 288
2020/1/10, 13:00:00, 28710, 28747, 28680, 28697, 2629, 2399, 1318, 1311
2020/1/10, 14:00:00, 28696, 28719, 28653, 28718, 2942, 2673, 1489, 1453
2020/1/10, 15:00:00, 28719, 28757, 28708, 28751, 2723, 2450, 1330, 1393
2020/1/10, 16:00:00, 28751, 28758, 28670, 28695, 2196, 1981, 1141, 1055
2020/1/10, 17:00:00, 28695, 28724, 28661, 28716, 1038, 944, 534, 504
2020/1/10, 18:00:00, 28715, 28778, 28713, 28768, 1048, 924, 480, 568
2020/1/13, 01:00:00, 28710, 28927, 28710, 28755, 38446, 34038, 19472, 18974
2020/1/13, 02:00:00, 28756, 28984, 28718, 28973, 36948, 32723, 17699, 19249
2020/1/13, 03:00:00, 28973, 29013, 28902, 28938, 17020, 14925, 8596, 8424
2020/1/13, 04:00:00, 28937, 28937, 28937, 28937, 14, 8, 2, 12
2020/1/13, 05:00:00, 28938, 28974, 28918, 28964, 11192, 9922, 5464, 5728
2020/1/13, 06:00:00, 28963, 29029, 28949, 29005, 12005, 10751, 5770, 6235
2020/1/13, 07:00:00, 29005, 29039, 28954, 28978, 11591, 10357, 6101, 5490
2020/1/13, 08:00:00, 28978, 28995, 28940, 28962, 7756, 6279, 3981, 3775
2020/1/13, 09:00:00, 28962, 28981, 28931, 28975, 1665, 1469, 821, 844
2020/1/13, 10:00:00, 28976, 28976, 28942, 28950, 963, 899, 507, 456
2020/1/13, 11:00:00, 28952, 28961, 28914, 28918, 1252, 1175, 695, 557
2020/1/13, 12:00:00, 28918, 28940, 28907, 28934, 1283, 1206, 654, 629
2020/1/13, 13:00:00, 28933, 28949, 28919, 28931, 905, 841, 505, 400
2020/1/13, 14:00:00, 28930, 28953, 28887, 28950, 3198, 2942, 1634, 1564
2020/1/13, 15:00:00, 28951, 28997, 28938, 28996, 2812, 2488, 1365, 1447
2020/1/13, 16:00:00, 28995, 29072, 28987, 29069, 2929, 2548, 1409, 1520
2020/1/13, 17:00:00, 29069, 29126, 29065, 29121, 1498, 1342, 710, 788
2020/1/13, 18:00:00, 29120, 29174, 29119, 29152, 1816, 1599, 912, 904
2020/1/14, 01:00:00, 29200, 29222, 29031, 29048, 36548, 31761, 18574, 17974
2020/1/14, 02:00:00, 29048, 29095, 28964, 29030, 32892, 28845, 17172, 15720
2020/1/14, 03:00:00, 29029, 29040, 28905, 28951, 22904, 20498, 11981, 10923
2020/1/14, 04:00:00, 28955, 28955, 28955, 28955, 64, 29, 0, 64
2020/1/14, 05:00:00, 28951, 29005, 28909, 28924, 14187, 12628, 7142, 7045
2020/1/14, 06:00:00, 28924, 28955, 28890, 28942, 13476, 12124, 6816, 6660
2020/1/14, 07:00:00, 28940, 28946, 28848, 28870, 12173, 10922, 6251, 5922
2020/1/14, 08:00:00, 28870, 28894, 28844, 28859, 6613, 5479, 3044, 3569
